
  C 100, 100, 100

      WE assets/space.png

  NO assets/bridge.png
                              EA assets/fire.png

SO assets/vineyards.png

   F 255,255,255

        11111111111111111
        10100000000000001
        1010000000000001
        10000000000000001
1111111110100000000000001
1000000000101011111111111
111101111100000100011
111101111110100010001
110000001100000010001
  1000000010000000101
110000000010100010001
1000001110011111W001
11110111 100000001001
111111111 1111111111
