NO assets/north2.png
SO assets/south2.png
WE assets/west2.png
EA assets/east2.png

F 222,184,135
C 80,150,255

111111
1N0001
100001
111111
