NO assets/north3.png
SO assets/south3.png
WE assets/west3.png
EA assets/east3.png

F 222,184,135
C 80,150,255

111111
1000E1
101001
100001
111111
