NO assets/north2.png
SO assets/south2.png
WE assets/west2.png
EA assets/east2.png

F 222,184,135
C 80,150,255

1111111
10000E1
1001001
101 1001
1001001
111111
