NO assets/north3.png
SO assets/south3.png
WE assets/west3.png
EA assets/east3.png
F 222,184,135
C 80,150,255

                             1111
                           1111
                             111
  1                         1
    1111111111111111111111111111111111111111111111111111111111111111111
11111E00000000000000000000000000000000000000000000000000000000000000001
1   1111111111111111111111111111111111111111111111111111111111111111111

11111111111111111111111111111
11111111111111111111111111111
11111111111111111111111111111
11111111111111111111111111111
11111111111111111111111111111
11111111111111111111111111111
11111111111111111111111111111
11111111111111111111111111111
10000000000000000000000000001
10000000000000000000000000001
10000000000000000000000000001
10000000000000000000000000001
10000000000000000000000000001
11111111111111111111111111111