NO assets/north3.png
SO assets/south3.png
WE assets/west3.png
EA assets/east3.png
F 222,184,135
C 80,150,255

                         
 1111111111111111111111111 
 1000000000000000000000001 
 1000E00000000000000000001 
 1111111111111111111111111 
                          