NO assets/north2.png
SO assets/south2.png
WE assets/west2.png
EA assets/east2.png

F 222,184,135
C 80,150,255

111111111111111111111                                                                   111111111111111111111111111111111111111111111111111111111111111111
100000000110000001111                                                                   1000000000000000000000000000000000000000000000000000000000000000001
11110111111111011100111111111111111111111111111111111111111111111111111111111111111111110000000000000000000000000000000000000000000000000000000000000000001
11110111111111011100000000000000000000000000000000000000000000000000000000000000000000000000000000000000000000000000000000000000000000000000000000000000001
10000000000000000000111111111111111111111111111111111111111111111111111111111111111111110000000000000000000000000000000000000000000000000000000000000000001
10N000000001111101101                                                                   111111111111111111111111111111111111111111111111111111111111111111
111111111111111111111
