NO assets/north3.png
SO assets/south3.png
WE assets/west3.png
EA assets/east3.png

F 222,184,135
C 80,150,255

1111111111                11111111111111111111111111
1000000001               100000000000000000000000001
101010111011111111111111110000000000000000000000001
110010110000000000000000000000000000000000000000001
1000000001111111111111111000000000000000000000000001
10N0001101               11111111111111111111111111
1111111111
