NO assets/north3.png
SO assets/south3.png
WE assets/west3.png
EA assets/east3.png

F 222,184,135
C 80,150,255

1111111111         11111111111111
1000000001        100000000000001
100100000111111111110000110000001
11N011010000000000000001  1000001
101100000111111111000000110000001
1000001101        111110000011111
1111111111             11111     
