NO assets/north.png
SO assets/south.png
WE assets/west.png
EA assets/east.png

F 222,184,135
C 80,150,255

111111111111111111111                                                                                                      111111111111111111111111111111111111111111111111111111111111111111
1N0000000110000001111                                                                                                     10000000000000000000000000000000000000000000000000000000000000000001
1111011111111101110011111111111111111111111111111111111111111111111111111111111111111111111111111111111111111111111111111110000000000000000000000000000000000000000000000000000000000000000001
1111011111111101110000000000000000000000000000000000000000000000000000000000000000000000000000000000000000000000000000000000000000000000000000000000000000000000000000000000000000000000000001
1000000011010101110000000000000000000000000000000000000000000000000000000000000000000000000000000000000000000000000000000000000000000000000000000000000000000000000000000000000000000000000001
1000000000000001100011111111111111111111111111111111111111111111111111111111111111111111111111111111111111111111111111111110000000000000000000000000000000000000000000000000000000000000000001
100000000001111101101                                                                                                      111111111111111111111111111111111111111111111111111111111111111111
111111111111111111111
