
SO ./assets/south.png


F 220,2991,2

WE ./assets/west.png
EA ./assets/east.png
C 225,0,0
NO ./assets/north.png


11111111111111
10000000001101
11110111111111
11110111111111
11000000110101
1000000S000001
10000000000001
11000001110101
11110111 11101
11111111 11111
