NO assets/north.png
SO assets/south.png
WE assets/west.png
EA assets/east.png

F 34,139,34
C 135,206,235

111111111111111111111
100000000110000001111
111101111111110111001
111101111111110111011
100000001101010111001
1000E0000000000110001
100000000001111101101
111111111111111111111
