NO assets/north.png
SO assets/south.png
WE assets/west.png
EA assets/east.png

F 34,139,34
C 135,206,235

        1111111111111111111111111
        1000000000110000000000001
        1011000001110000000000001
        1001000000000000000000001
111111111011000001110000000000001
100000000011000001110111111111111
11110111111111011100000010001
11110111111111011101010010001
1100000011010101110000000001
100000000000000110000000001
10000000000111110110101000011
1100000111100011111011110000111
11110111 1110N11 101111010001
11111111 1111111 111111111111
