NO assets/north2.png
SO assets/south2.png
WE assets/west2.png
EA assets/east2.png

F 220 ,   100 ,     0    
C     225, 999,    0

        1111111111111111111111111
        1000000000110000000000001
        101100000111000000000001
        1001000000000000000000001
111111111011000001110000000000001
100000000011000001110111111111111
1111011111  10111000000100011
11110111111111011101010010001
11000000110101011100000010001
  100000000000000011000000101
11000000000000001101010010001
1000001110101011111011110N01
11110111 1110101 10111101001
111111111 1111111 1111111111
