NO assets/north.png
SO assets/south.png
WE assets/west.png
EA assets/east.png

F 222,184,135
C 80,150,255

111111111111111111111
1N0000000110000001111
111101111111110111001
111101111111110111011
100000001101010111001
100000000000000110001
100000000001111101101
111111111111111111111
